    WE      we.xpm
F 164, 169,20



EA ea     .xpm
NO no.xpm
SO so.xpm

C 153,204,255


   111111111111111111111
111000001000000000001
101010101011111110001
100010100010000010001
111110101111101011101
11111011101101111111
     101111101    111111111111
111110001111111111101
101011111010111110101
111111111111111111111
111111111111111111111
10000010101000001
111111101011111011111
100000101000100010001
101110111110101110111
101000111000100010101
101011111111111010101
100010000000000010001
101010111011111111101
111000001N00000000001
111111111111111111111
