F 76,76,76
C 99,99,99

NO no.xpm
SO so.xpm
WE we.xpm
EA ea.xpm

1111111111111111111
10W1001001001000001
1011000001000001001
1001001001111101111
1001111000001001001
1000000001000001001
1001111111111001001
1111000001000001011
1000000001000000001
1111111111111111111

