F 0,0,255
C 171,154,137

NO textures/paneling.png
EA textures/Tileable3g.png
SO textures/Tileable4c.png
WE textures/Tileable6.png

1111111111111111111
1001001001001001001
1001001001001001001
1001001001001001001
1001001000001001001
1000000000000000001
1000011111111000001
1111000000000001111
100N000101010000001
1111111111111111111

