F 0,0,255
C 171,154,137

NO textures/paneling.png
EA textures/Tileable3g.png
SO textures/Tileable4c.png
WE textures/Tileable6.png

1111111111111111111
1001001001001001001
1001001001001001001
1001001001001001001
1001001000001001001
1000000000000000001
1000000000000000001
1000000000000000001
1000000000000000001
1000000000000000001
1000000000000000001
1000000000000000001
1000000000000000001
111100000N000001111
1000000101010000001
1111111111111111111

